
NO ./textures/unnamed.png
SO ./textures/unnamed.png
WE ./textures/unnamed.png
EA ./textures/unnamed.png

F 255,255,255
C 0,191,255

111111
100001
10E0001
100001
111111
