
NO ./textures/unnamed.png
SO ./textures/unnamed.png
WE ./textures/unnamed.png
EA ./textures/unnamed.png 

F 195,203,110
C 228,230,168

111111111111111111111111111111111111111111111111111111111111111111111111111111111111111111111111111111111111111111111111111111111111111111111111111111111111111111
100000000000000000000000000000000000000000000000000000000000000000000000000000000000000000000000000000000000000000000000000000000000000000000000000000000000000001
100000000000000000000000000111111111111111111111111111111111111111111111111111111111111111111111111111111111111111111111111111111111111111111111111111111111111111
10000111100000000E0100000001
1000011110000000000000000001
1000011110000000001100000001
1000000000000000001100000001
1100000000000000000000000001
1000011110000000111000000001
1000011110000000111000000001
1000011110000000111000000001
1000000000000000000000000001
1111111111111111111111111111
